TL HH HH HH HH HH HH HH HH HH HH TR
VV EE EE EE EE EE EE EE EE EE EE VV
VV EE EE EE EE EE EE EE EE EE EE VV
VV EE EE EE EE EE EE EE EE EE EE VV
VV EE EE EE TL HH HH TR EE EE EE VV
VV EE EE EE VV EE EE EE EE EE EE VV
VV EE EE EE VV EE EE VV EE EE EE VV
VV EE EE EE BL HH HH BR EE EE EE VV
VV EE EE EE EE EE EE EE EE EE EE VV
VV EE EE EE EE EE EE EE EE EE EE VV
VV EE EE EE EE EE EE EE EE EE EE VV
BL HH HH HH HH HH HH HH HH HH HH BR