TL HH HH HH HH HH HH HH HH HH HH TR
VV EE EE EE VV EE EE EE EE EE EE VV
VV EE EE EE VV EE EE EE EE EE EE VV
VV EE VV EE VV EE VV HH HH EE EE VV
VV EE VV EE VV EE VV EE EE EE EE VV
VV EE VV EE VV EE VV EE EE HH HH VV
VV EE VV EE VV EE VV EE EE EE EE VV
VV EE VV EE VV EE VV HH HH EE EE VV
VV EE VV EE VV EE VV EE EE EE EE VV
VV EE VV EE EE EE VV EE EE HH HH VV
VV EE VV EE EE EE VV EE EE EE EE VV
BL HH HH HH HH HH HH HH HH HH HH BR
